1111111111111111111111111111111111111
1C0100110C1000C1000010C000000000C1111
100000E101100000000010010000001111C11
1001001100000100001010011110001100001
1001000000111100011000010100000111001
100001011000C10000001000C100111100001
1111010C10111100011110111010011110001
1C01010010000101001C000111100C0110001
1001000010110101001000011C10000010111
100001011C100101000000011010000010111
1111010011100101011110011010000000111
1C00011010000100001C00010001000001011
11010100001001010000010101010111110C1
1101011110100101011111010111110000001
10C100C0001C000100C1P0000000000011111
1111111111111111111111111111111111111
