
111111
1P0001
100001
100001
10E0C1
111111