11111111111111111
100100001110001C1
10000110110001101
11110000C00100001
10C11000011011001
10110001111000001
10000111110001111
1011000C1100010C1
1P000111010000001
10C001E0000111101
11111111111111111
